5 5 5 5 5 5 5 5 5 5 5 5 5 5 5 5 5 5
5 5 5 5 5 5 5 5 5 5 5 5 5 5 5 5 5 5
5 3 3 3 3 3 3 3 3 3 3 3 3 3 3 3 3 5
5 3 0 0 0 0 0 0 1 1 2 2 2 0 0 0 3 5
5 3 0 2 0 2 2 2 1 2 0 0 1 1 1 0 3 5
5 3 0 2 0 2 1 1 1 1 0 1 1 4 1 2 3 5
5 3 0 0 0 2 1 4 1 2 0 2 2 2 1 2 3 5
5 3 1 2 0 1 1 2 2 2 0 1 1 0 0 2 3 5
5 3 1 1 0 1 0 2 2 1 1 2 4 1 0 0 3 5
5 3 2 1 2 1 0 1 0 1 0 2 1 1 2 1 3 5
5 3 0 0 0 0 1 2 1 2 0 2 1 2 2 1 3 5
5 3 1 1 2 1 2 0 0 0 0 0 0 0 0 0 3 5
5 3 4 1 1 0 0 0 1 1 2 2 2 1 0 2 3 5
5 3 3 3 3 3 3 3 3 3 3 3 3 3 3 3 3 5
5 5 5 5 5 5 5 5 5 5 5 5 5 5 5 5 5 5